R 1920 1080

NO ./textures/north.png
SO ./textures/south.png
WE ./textures/west.png
EA ./textures/east.png
S ./textures/sprite.png
F 220,100,0
C 225,30,0

111111111111111111111111111
100001000100110000000000001
101111011100010000000000001
100001001000000000002000201
101111011000001110000000001
100200001000000100000200011
110000011000000111110000201
100000000110202000110011111
111000200011000011100020111
110000001111000110002000001
11002000000110001100N000001
100011000011100000000111111
111111111111111111111111111