R 1000 800

NO ./texture/cube_marble.xpm
SO ./texture/white_marble.xpm
WE ./texture/black_marble.xpm

EA ./texture/blue_marble.xpm
S ./texture/head.xpm
F 196,164,191
C 164,193,128

111111111111111111111111111
100001000100110000000000001
101111011000010000000000001
100001001000000000002000201
100111011000001110000000001
100200001000000100000200011
110000011000000111110000201
100000000000202000110011111
111000200011000011120000111
110000001111000110000000001
11002000000110001100N000001
111111000011100000000111111
111111111111111111111111111