R 1920 1080

NO ./textures/north.png
SO ./textures/south.png
WE ./textures/west.png
EA ./textures/east.png
S ./textures/sprite.png
F 220,100,0
C 225,30,0

111111111111111111111111111111111
100000001000100000110000000000001
100001111011100001110000000000001
100000001001000000000000002000201
101111111011000000001110000000001
100000200001000000000100000200011
111000000011000000000111110000201
100000000000000110202000110011111
111000000200000011000011100020111
110000000001111111000110002000001
11000002000000000110001100N000001
100000011000000011100000000111111
1111111111111111111111111111